1111100002
0000000000
0000200000
0000000000
0000000000
0000000000
0001010000
0001210000
0001110000
0000000000