1111100222
0000000000
0000200000
0000000000
0000000000
0000000000
0001110000
0001210000
0001110000
0000000000