1111100000
0000000000
0000000000
0000000000
0001111100
0000000000
0000000000
0000000000
0000000000
0000000000